5542040000
2300000032
0000110000
0200120020
0200210020
0001221000
0000000000
0012222100
0000000000
0000000000