20
0000000000
0000000000
0000444444
0055000005
0055000005
0055000005
0055600005
0000444044
0000440440
0000440440
0000440440
0000440440
0000440440
0000440440
0000000000