20
0000000000
0000000000
0000000000
0000000000
0012345100
0000000000
0000000000
0221100120
0000000000
0000000000
0000000000